###########################A#########################
##   ######### #####        ################## ######
##### #####          #### ##### ############### #####
##### ##### ### ######### ##### ############### #####
###     ### ###   ###     ### ###   ########### #####
####### ### ### # ##### ##### ##### ############ ####
####### ### ### # ##### ##### ###   ############ ####
####### ### ### ### ##### ##### ##### ########### ###
####### ### ### ### ##### ##### ##### ########### ###
#####   ### ### ### ##### ##### ##### ########### ###
##### ###         ##### ##### ##### ########### #####
##### ### ### ### ##### ##### ##### ########### #####
##### ### ### ### ##### ##### #####   ############ ##
###   ### ###     # ##### ##### ###   ############ ##
### ###         ##### ##### ##### ##### ########### #
### ### ### ### ##### ##### ##### ##### ########### #
### ### ### ### ##### ##### ##### #####   ######### #
### ### ###   ### ##### ##### ##### ########### ### #
### ### ##### ##### ##### ##### ##### ########### ###
### ### ##### ##### ##### ##### ##### ########### ###
### ### ##### ##### ##### ##### ##### ########### ###
###   #     ### ##### ##### ##### ##### ########### #
####### ### ### ##### ##### ##### #####   ######### #
####### ### ### ##### ##### ##### ############### ###
####### ### ### ##### ##### ##### ############### ###
#       ###   ### ##### ##### ##### ############### #
##B##################################################