################B###
###     ######## ###
### ### ####     ###
### ### ######## ###
####### ######## ###
### ### #####    ###
###     ##### ######
####### ##### ######
####### #####    ###
##      ######## ###
## ############# ###
## ############# ###
#                ###
## #################
##A#################