##B#####
## #####
##   ###
#### ###
#    ###
#A######